R 1000 750
NO ./textures/redbrick.xpm
SO ./textures/eagle.xpm
WE ./textures/purplestone.xpm
EA ./textures/greystone.xpm
S ./textures/greenlight.xpm
F 182,182,182
C 182,182,182


11111111111111111111111111111111111111111111111111111111111111111111111111111111111111111111111
10000000000000000000S000000000000000000000000000000000000000000000000000000000000000000000000011111111
1000000000000000000000000000000000000000000000000000000000000000000000000000000000000000000000000000011
1000000000000000000000000000000000000000000000000000000000000000000000000000000000000000000000000000011
1000000000000000000000000000000000000000000000000000000000000000000000000000000000000000000000000000011
1000000000000000000000000000000000000000000000000000000000000000000000000000000000000000000000000000011
1111111111111111111111111111111111111111111111111111111111111111111111111111111111111111111111111111111

