R 1200 840
NO ./textures/redbrick.xpm
SO ./textures/eagle.xpm
WE ./textures/purplestone.xpm
EA ./textures/greystone.xpm
S ./textures/greenlight.xpm
F 220,100,2
C 225,30,0

11111111111111
10200000000001
10000000000001111111111
11111002000200000020001
    1000000000011111111
    100200020001
    100000000001     111111
    10000000000111111102001  111    111    1   1   1  1
    11111111000000000000001  1  1   1  1   1   1   1  1
           10000000000000111111    1111   1   1   1111
           100000S000002001  1  1   1  1   1   1   1  1
  1111111111000000000000001  11111111  1111111111111  1
  1000000000000000000000001
  1000002222222222222220001
  10200201111111111111100011
  10000001            100001
  1020020111111111    100001
  10000000000000011111111101
  11111111111111000000000001
               1111111001111
                     1001
            11111    1001
            1000111111001
            1020000000001
            1000000000001
            1111111111111111111
