R 800 640
NO ./textures/redbrick.xpm
SO ./textures/redbrick.xpm
WE ./textures/redbrick.xpm
EA ./textures/mossy.xpm
S ./textures/greenlight.xpm
F 255,182,122
C 102,080,182

11111111111111111111111111111
10000000000011111110000000011
10000S00000010000010000000001
10000000000010000011111211111
10000000000010000010000000001
10000000000011131110000000001
10000000000000000000000111111
10000001110000011100000230001
10000001 1000001 100000110001
11111111 1111111 111111111111

